after	NULL	TrueFalse
and	TrueFalse	TrueFalse
at_location	NULL	TrueFalse
before	NULL	TrueFalse
#concept	NULL	TrueFalse
count	EventSet	Number
delta	EventSet	TrueFalse
dose	Event	Number
duration	Event	Number
earliest	EventSet	Event
frequency	Event	Number
greater_than	NULL	TrueFalse
has_call	NULL	EventSet
has_concept	NULL	TrueFalse
is_decreasing	EventSet	TrueFalse
is_doctor	Event	TrueFalse
is_healed	Event	TrueFalse
is_high	Event	TrueFalse
is_increasing	EventSet	TrueFalse
is_large	Event	TrueFalse
is_negative	Event	TrueFalse
is_normal	Event	TrueFalse
is_positive	Event	TrueFalse
is_primary	Event	TrueFalse
is_problem	NULL	TrueFalse
is_relative	NULL	TrueFalse
is_response	NULL	TrueFalse
is_result	Event	TrueFalse
is_serious	NULL	TrueFalse
is_significant	Event	TrueFalse
is_treatment	NULL	TrueFalse
#lambda.concept	TrueFalse	EventSet
#lambda.hasrelative	NULL	EventSet
lambda.isrelative	NULL	EventSet
lambda.timeunit	NULL	EventSet
lambda	TrueFalse	EventSet
latest	EventSet	Event
less_than	NULL	TrueFalse
location	Event	Location
max	EventSet	Event
min	EventSet	Event
positive	EventSet	EventSet
reason	Event	TrueFalse
severe	EventSet	EventSet
staff	NULL	TrueFalse
sum	EventSet	Number
summary	EventSet	Summary
time	Event	Time
time_within	NULL	TrueFalse
trend	EventSet	Trend
